Date,Debit,Credit,Balance 
03 Jul 2024,,99000.0,100949.17
03 Jul 2024,,100.0,101049.17
03 Jul 2024,,100.0,101149.17
03 Jul 2024,,65800.0,166949.17
03 Jul 2024,160416.0,,6533.17
03 Jul 2024,839.7,,5693.47
03 Jul 2024,234.36,,5459.11
03 Jul 2024,3509.94,,1949.17
